SO    ./textures/south_image.png
NO      ./textures/north_image.png
EA 					./textures/east_image.png
WE  	   ./textures/west_image.png





C    0, 20, 45
F    101, 67, 0





1111111111111111111111111
1000000000110000000000001
1012000011200000W0000001
1001000000000000000000001
11111121102100000211000010000001
100000000011000101110121111111111
1111011112111102000000010001
11110000000000011101010010001
11000000110101011100000000001
10000000000000001100000010001
10001000000000001101010010001
110000011101010111110111100111
11110111 1110101 101111010001
11111111 1111111 111111111111

