SO    ./textures/south_image.png
NO      ./textures/11.png
EA 					./textures/22.png
WE  	   ./textures/4.png





C    135, 20, 45
F    101, 67, hdg





1111111111111111111111111
1000000000110000000000001
101100001110000000000001
1001000000000000000000001
11111111101100000111000010000001
100000000011000001110111111111111
11110111111111011100000010001
11110111111111011101010010001
11000000110101011100000000001
1E000000000000001100000010001
10001000000000001101010010001
110000011101010111110111100111
11110111 1110101 101111010001
11111111 1111111 111111111111






