SO    ./textures/south_image.png
NO      ./textures/north_image.png
EA 					./textures/east_image.png


WE    			 	   ./textures/west_image.png



C    0, 0, 0
F    101, 67, 0





1111111111111111111111111
100000000011000000000001
10010000003000000000001
100100000010000000000011
1001000000100000000000001
11111121111121111331000010000001
100000000011000133310001111111111
1111011112111100000000010001
11110000000000011100010010001
11000000330101011100000000001
10000000000000000200000010001
10003000000000033301010010001
110000011101010111110111100111
11110111 1110101 101111010001
11111111 1111111 111111111111


