NO      ./textures/north_image.png
SO ./textures/south_image.png
EA ./textures/east_image.png
WE ./textures/west_image.png
           
C   245,230,0
F    220,100,0
			


     



1111111111111111111111111
1111111000110000000000001
1011000001110000000000001
100100000000000000000000111111111        
111111111011000001110000000000001       
100000000011000001110111111111111        
11110111111111011100000010001
11110111111111011101010010001
1100000111110101110000001000111      
10001001111000001100000010001
10000001111000001101010010001
110000011101010111110111100111
11110S11111101011101111010001
11111111111111111111111111111
 
      





