NO      ./textures/north_image.png
SO ./textures/south_image.png
EA ./textures/east_image.png
WE ./textures/west_image.png

C   245,230,0





F    220,100,40

1111111111111111111111111
1000000000110000000000001
101100001110000000000001
1001000000000000000000001
1111111110110000011100001
1000000000110000011111111
11110111111111011100000010001
11110111111111011101010010001
11000000110101001100000011001
1000000000000000000000000111
1000000S000000001101010010001
11000001110101011111011111
11110111 1110101 101111010001
11111111 1111111 111111111111







