NO      ./textures/north_image.png
SO ./textures/south_image.png
EA ./textures/east_image.png
WE ./textures/west_image.png
           
C   245,230,0
			


     

F    220,100,40

1111110111111111111111111
1000000000110000000000001
1011000001110000000000001
1001000000000000000000001
111111111011000001110000000000001
100000000011000001110111111111111
11110111111111011100000010001
11110111111111011101010010001
11000000110101001100000010001
1000000000000000000000000011
10000000000000001101010010001
11000001110101011111011110N0111
11110111 1110101 101111010001
11111111 1111111 111111111111
 
      





