SO    ./textures/south_image.png
NO      ./textures/north_image.png
EA 					./textures/east_image.png
WE  	   ./textures/west_image.png





C    0, 20, 45
F    101, 67, 0





1111111111111111111111111
1000000030000000000000001
100000001110000000N000001
1000000030000000000000001
1000000030000000000000001
1111112110110000011100001
1000000000110000011101111
1111011111111101110000001
1111011111111101110101001
1100000011010101110000001
1000000000001000000000001
1000100000000000110101001
1111111111111111111111111

